...###
..##.#.####
.##..###..#
##........#
#.....#..#
###..###..#
..#..#....#
.##@##.#.##
.......##
......##
.#######